13 10 5 10
1 1 1 1 1 1 1 1 1 1 1 1 1 
1 2 1 4 0 0 0 0 0 0 0 4 1
1 0 1 1 3 0 1 1 0 1 0 0 1
1 0 0 0 1 0 0 0 0 1 1 0 1
1 0 0 0 1 1 1 1 0 1 3 0 1
1 1 1 0 1 0 0 0 0 1 0 0 1
1 0 5 0 1 0 1 0 0 1 0 1 1
1 4 1 0 0 0 1 0 0 1 0 0 1
1 0 0 0 0 0 1 0 0 1 0 9 1
1 1 1 1 1 1 1 1 1 1 1 1 1