20 10 4 10
1 1 1 1 1 1 1 1 1 1 1 1 1 1 1 1 1 1 1 1 
1 0 4 0 1 0 3 0 1 0 1 5 1 4 3 1 0 0 9 1
1 0 1 0 1 0 1 0 1 0 0 0 0 1 0 1 0 0 0 1
1 0 1 0 1 0 1 0 0 0 1 1 0 1 0 0 0 1 0 1
1 0 1 0 4 0 1 0 1 0 1 1 0 0 1 1 1 0 0 1
1 0 1 0 1 0 1 0 0 0 0 0 1 0 0 0 1 0 1 1
1 0 1 0 1 0 1 0 1 0 1 0 1 1 1 0 1 0 0 1
1 2 0 0 1 0 1 0 1 0 1 0 0 4 1 0 0 1 0 1
1 0 1 0 0 0 0 0 1 0 1 0 0 0 4 1 0 0 0 1
1 1 1 1 1 1 1 1 1 1 1 1 1 1 1 1 1 1 1 1 
 