20 13 6 10
1 1 1 1 1 1 1 1 1 1 1 1 1 1 1 1 1 1 1 1 
1 0 0 0 0 0 0 0 0 0 0 0 0 4 4 4 9 1 9 1
1 0 0 1 1 1 1 1 1 1 1 1 1 1 1 1 1 1 0 1
1 0 0 0 0 0 0 0 0 0 0 0 0 0 0 0 3 1 0 1
1 1 0 1 0 0 0 0 0 0 0 0 0 0 0 0 0 1 0 1
1 0 0 0 0 0 0 0 0 0 0 0 0 0 0 0 0 1 0 1
1 1 1 1 1 1 1 1 1 1 1 1 0 1 0 1 0 1 0 1
1 0 0 0 0 0 0 0 0 0 0 1 0 1 0 0 4 1 0 1
1 1 0 1 1 1 0 1 0 1 1 1 0 1 1 1 1 1 0 1
1 2 0 1 0 3 0 0 4 1 0 0 0 0 0 0 0 0 0 1
1 0 1 1 0 1 0 1 0 1 0 1 0 1 0 1 0 1 0 1
1 0 0 1 0 5 0 0 0 0 0 1 0 0 0 0 0 0 0 1
1 1 1 1 1 1 1 1 1 1 1 1 1 1 1 1 1 1 1 1 